####################
#++W ++  ++  ++ W++#
#++  ++  ++  ++  ++#
#BB++  ++  ++  ++BB#
#BB++  ++  ++  ++BB#
#++  ++NN++NN++  ++#
#++  ++NN++NN++  ++#
#BB++  ++I ++  ++BB#
#BB++  ++  ++  ++BB#
#++  ++NN++NN++  ++#
#++  ++NN++NN++  ++#
#BB++  ++  ++  ++BB#
#BB++  ++  ++  ++BB#
#++  ++NN++NN++  ++#
#++  ++NN++NN++  ++#
#BB++  ++  ++  ++BB#
#BB++W ++  ++ W++BB#
####################