#####################
#####################
#########PPP#########
#########PPP#########
#####W +++++++ W#####
#####  H H H H  #####
#####++ +++ ++++#####
#####           #####
###BB++++ +++ ++BB###
###BB  H H H H  BB###
###BB++ +++ ++++BB###
#####  H H H H  #####
#####++++ +++ ++#####
#####  H H H H  #####
#####  +++++++  #####
#########   #########
#########  I#########
#####################
#####################
