GGGGGGGGGGGGGGGGGGG
GMMMMMMMMGMMMMMMMMG
GMGGMGGGMGMGGGMGGMG
GMGGMGGGMGMGGGMGGMG
GMMMMMMMMMMMMMMMMMG
GMGGMGMGGGGGMGMGGMG
GMMMMGMMMGMMMGMMMMG
GGGGMGGGMGMGGGMGGGG
   GMG       GMG
GGGGMG GGQGG GMGGGG
GMMMMM GVVVG MMMMMG
GGGGMG GGGGG GMGGGG
   GMG   Z   GMG
GGGGMG GGGGG GMGGGG
GMMMMM   G   MMMMMG
GMGGMGGG G GGGMGGMG
GMMGMMMM   MMMMGMMG
GGMGMGMGGGGGMGMGMGG
GMMMMGMMMGMMMGMMMMG
GMGGGGGGMGMGGGGGGMG
GMMMMMMMMMMMMMMMMMG
GGGGGGGGGGGGGGGGGGG