GGGGGGGGGGGGGGGGGGGGG
GGGGGGGGGGGGGGGGGGGGG
GGGGGGGGGPPPGGGGGGGGG
GGGGGGGGGPPPGGGGGGGGG
GGGGGW FFFFFFF WGGGGG
GGGGG  E E E E  GGGGG
GGGGGFF FFF FFFFGGGGG
GGGGGJ         JGGGGG
GGGBBFFFF FFF FFBBGGG
GGGBB  E E E E  BBGGG
GGGBBFF FFF FFFFBBGGG
GGGGG  E E E E  GGGGG
GGGGGFFFF FFF FFGGGGG
GGGGG  E E E E  GGGGG
GGGGG  FFFFFFF  GGGGG
GGGGGGGGG   GGGGGGGGG
GGGGGGGGG  ZGGGGGGGGG
GGGGGGGGGGGGGGGGGGGGG
GGGGGGGGGGGGGGGGGGGGG