##############
#            #
# +NN+NN+NN+ #
# HHHHHHHHHH #
# HHHHHHHHHH #
#            #
# +NN+NN+NN+ #
#            #
#DHHHHHHHHHHD#
# HHHHHHHHHH #
#            #
# +NN+NN+NN+ #
#            #
# HHHHHHHHHH #
# HHHHHHHHHH #
# +NN+NN+NN+ #
#     I      #
##############

