GGGGGGGGGGGGGGGGGGGG
GY     QQQQQQ     YG
G FFFFFFFFFFFFFFFF G
G FY    OOOO    YF G
G F FFFFF  FFFFF F G
G F FY   KK   YF F G
G F F FFFFFFFF F F G
G F FYF      FYF F G
G FKF F  BB  F FKF G
G FKF F  BB  F FKFLG
GZ  F    TT    F  LG
G   F          F  LG
G FKF F  BB  F FKFLG
G FKF F  BB  F FKF G
G F FYF      FYF F G
G F FFFFF  FFFFF F G
G FY    OOOO    YF G
G FFFFFFFFFFFFFFFF G
GY     QQQQQQ     YG
GGGGGGGGGGGGGGGGGGGG