GGGGGGGGGGGGGGGGGGG
GKKKKKKKKGKKKKKKKKG
GKGGKGGGKGKGGGKGGKG
GKGGKGGGKGKGGGKGGKG
GKKKKKKKKKKKKKKKKKG
GKGGKGKGGGGGKGKGGKG
GKKKKGKKKGKKKGKKKKG
GGGGKGGGKGKGGGKGGGG
   GKG       GKG
GGGGKG GG GG GKGGGG
GKKKKK GVVVG KKKKKG
GGGGKG GGGGG GKGGGG
   GKG   Z   GKG
GGGGKG GGGGG GKGGGG
GKKKKK   G   KKKKKG
GKGGKGGG G GGGKGGKG
GKKGKKKK   KKKKGKKG
GGKGKGKGGGGGKGKGKGG
GKKKKGKKKGKKKGKKKKG
GKGGGGGGKGKGGGGGGKG
GKKKKKKKKKKKKKKKKKG
GGGGGGGGGGGGGGGGGGG