####################
#D     SSSSSS     D#
# ++++++++++++++++ #
# +D    NNNN    D+ #
# + +++++  +++++ + #
# + +D   PP   D+ + #
# + + ++++++++ + + #
# + +D+      +D+ + #
# +P+ +  BB  + +P+ #
# +P+ +  BB  + +P+A#
#I  +    JJ    +  A#
#   +          +  A#
# +P+ +  BB  + +P+A#
# +P+ +  BB  + +P+ #
# + +D+      +D+ + #
# + +++++  +++++ + #
# +D    NNNN    D+ #
# ++++++++++++++++ #
#D     SSSSSS     D#
####################