###################
#PPPPPPPP#PPPPPPPP#
#P##P###P#P###P##P#
#P##P###P#P###P##P#
#PPPPPPPPPPPPPPPPP#
#P##P#P#####P#P##P#
#PPPP#PPP#PPP#PPPP#
####P###P#P###P####
   #P#PPPPPPP#P#
####P#P##P##P#P####
#PPPPPP#PPP#PPPPPP#
####P#P#####P#P####
   #P#PPPPPPP#P#
####P#P#####P#P####
#PPPPPPPP#PPPPPPPP#
#P##P###P#P###P##P#
#PP#PPPPPPPPPPP#PP#
##P#P#P#####P#P#P##
#PPPP#PPP#PPP#PPPP#
#P######P#P######P#
#PPPPPPPPPPPPPPPPP#
###################
