###################
#PPPPPPPP#PPPPPPPP#
#P##P###P#P###P##P#
#P##P###P#P###P##P#
#PPPPPPPPPPPPPPPPP#
#P##P#P#####P#P##P#
#PPPP#PPP#PPP#PPPP#
####P###P#P###P####
   #P#       #P#
####P# ## ## #P####
#PPPPP #RRR# PPPPP#
####P# ##### #P####
   #P#       #P#
####P# ##### #P####
#PPPPP   #   PPPPP#
#P##P### # ###P##P#
#PP#PPPP   PPPP#PP#
##P#P#P#####P#P#P##
#PPPP#PPP#PPP#PPPP#
#P######P#P######P#
#PPPPPPPPPPPPPPPPP#
###################

