#################
#I             R#
# +P+P+P+P+P+P+ #
# PP+P+P+P+P+P+ #
# +++P+P+P+P+P+ #
# PPPP+P+P+P+P+ #
# +++++P+P+P+P+ #
# PPPPPP+P+P+P+ #
# +++++++P+P+P+ #
# PPPPPPPP+P+P+ #
# +++++++++P+P+ #
# PPPPPPPPPP+P+ #
# +++++++++++P+ #
# PPPPPPPPPPPP+ #
# +++++++++++++ #
#R              #
#################