GGGGGGGGGGGGGG
G            G
G    Y       G
G            G
G       T    G
G  U         G
G            G
G            G
G     V      G
G            G
G            G
G     Z      G
GGGGGGGGGGGGGG