GGGGGGGGGGGGGGGGG
GZ             VG
G FKFKFKFKFKFKF G
G KKFKFKFKFKFKF G
G FFFKFKFKFKFKF G
G KKKKFKFKFKFKF G
G FFFFFKFKFKFKF G
G KKKKKKFKFKFKF G
G FFFFFFFKFKFKF G
G KKKKKKKKFKFKF G
G FFFFFFFFFKFKF G
G KKKKKKKKKKFKF G
G FFFFFFFFFFFKF G
G KKKKKKKKKKKKF G
G FFFFFFFFFFFFF G
GV              G
GGGGGGGGGGGGGGGGG