####################
#D     SSSSSS     D#
# ++++++++++++++++ #
# +D    NNNN    D+ #
# + +++++  +++++ + #
# + +D   PP   D+ + #
# + + ++++++++ + + #
# + +D+      +D+ + #
# + + +  BB  + + + #
# + + +  BB  + + + #
#I  +    JJ    +   #
#   +          +   #
# + + +  BB  + + + #
# + + +  BB  + + + #
# + +D+      +D+ + #
# + +++++  +++++ + #
# +D    NNNN    D+ #
# ++++++++++++++++ #
#D     SSSSSS     D#
####################