GGGGGGGGGGGGGG
G            G
G            G
G      Y     G
G            G
G            G
G            G
G            G
G            G
G            G
G            G
G     Z K    G
GGGGGGGGGGGGGG