GGGGGGGGGGGGGG
G            G
G FOOFOOFOOF G
G EEEEEEEEEE G
G EEEEEEEEEE G
G      T     G
G FOOFOOFOOF G
G            G
GYEEEEEEEEEEYG
G EEEEEEEEEE G
G            G
G FOOFOOFOOF G
G            G
G EEEEEEEEEE G
G EEEEEEEEEE G
G FOOFOOFOOF G
G     Z      G
GGGGGGGGGGGGGG